//MAP CONVERTED BY dmm2tgm.py THIS HEADER COMMENT PREVENTS RECONVERSION, DO NOT REMOVE
"a" = (
/turf/closed/wall/mineral/titanium,
/area/shuttle/supply)
"b" = (
/obj/effect/turf_decal/stripes/line{
	dir = 9
	},
/obj/effect/decal/cleanable/dirt,
/turf/open/floor/iron/smooth,
/area/shuttle/supply)
"c" = (
/obj/effect/turf_decal/stripes/line{
	dir = 1
	},
/turf/open/floor/iron/smooth_edge,
/area/shuttle/supply)
"d" = (
/obj/effect/turf_decal/stripes/line{
	dir = 8
	},
/obj/machinery/light{
	dir = 8
	},
/turf/open/floor/iron/smooth_edge{
	dir = 4
	},
/area/shuttle/supply)
"e" = (
/obj/effect/turf_decal/stripes/line{
	dir = 1
	},
/obj/effect/decal/cleanable/dirt,
/turf/open/floor/iron/smooth_edge,
/area/shuttle/supply)
"f" = (
/obj/effect/turf_decal/stripes/line{
	dir = 5
	},
/turf/open/floor/iron/smooth,
/area/shuttle/supply)
"g" = (
/obj/effect/turf_decal/stripes/line{
	dir = 8
	},
/obj/effect/decal/cleanable/dirt,
/turf/open/floor/iron/smooth_edge{
	dir = 4
	},
/area/shuttle/supply)
"h" = (
/obj/effect/turf_decal/bot,
/obj/effect/decal/cleanable/dirt,
/turf/open/floor/iron/smooth_large,
/area/shuttle/supply)
"i" = (
/obj/effect/turf_decal/bot,
/obj/effect/decal/cleanable/dirt,
/obj/effect/decal/cleanable/oil,
/turf/open/floor/iron/smooth_large,
/area/shuttle/supply)
"j" = (
/obj/effect/turf_decal/stripes/line{
	dir = 4
	},
/obj/machinery/light{
	dir = 4
	},
/turf/open/floor/iron/smooth_edge{
	dir = 8
	},
/area/shuttle/supply)
"k" = (
/obj/effect/turf_decal/stripes/closeup{
	dir = 1
	},
/obj/effect/decal/cleanable/dirt,
/obj/effect/turf_decal/caution/stand_clear{
	dir = 4
	},
/obj/machinery/door/poddoor{
	id = "cargoload";
	name = "supply Dock Loading Door"
	},
/turf/open/floor/plating,
/area/shuttle/supply)
"l" = (
/obj/machinery/power/shieldwallgen/atmos/strong/roundstart{
	id = 1
	},
/obj/effect/turf_decal/stripes/closeup{
	dir = 1
	},
/obj/effect/decal/cleanable/dirt,
/obj/machinery/conveyor{
	id = "cargoload";
	dir = 8
	},
/obj/machinery/door/poddoor{
	id = "cargoload";
	name = "supply Dock Loading Door"
	},
/turf/open/floor/plating,
/area/shuttle/supply)
"m" = (
/obj/effect/turf_decal/stripes/line{
	dir = 4
	},
/turf/open/floor/iron/smooth_edge{
	dir = 8
	},
/area/shuttle/supply)
"n" = (
/obj/docking_port/mobile/supply{
	dir = 4;
	dwidth = 4
	},
/obj/machinery/door/airlock/shuttle{
	name = "Supply Shuttle Airlock";
	req_access_txt = "31"
	},
/obj/structure/fans/tiny,
/obj/machinery/button/door{
	id = "cargoload";
	name = "Loading Doors";
	pixel_x = 8;
	pixel_y = -24
	},
/turf/open/floor/plating,
/area/shuttle/supply)
"o" = (
/obj/effect/turf_decal/stripes/line{
	dir = 8
	},
/turf/open/floor/iron/smooth_edge{
	dir = 4
	},
/area/shuttle/supply)
"p" = (
/obj/effect/turf_decal/caution/stand_clear{
	dir = 4
	},
/obj/effect/turf_decal/stripes/closeup{
	dir = 1
	},
/obj/machinery/door/poddoor{
	id = "cargoload";
	name = "supply Dock Loading Door"
	},
/turf/open/floor/plating,
/area/shuttle/supply)
"q" = (
/obj/effect/turf_decal/stripes/line{
	dir = 4
	},
/obj/effect/decal/cleanable/dirt,
/turf/open/floor/iron/smooth_edge{
	dir = 8
	},
/area/shuttle/supply)
"r" = (
/obj/effect/turf_decal/caution/stand_clear{
	dir = 4
	},
/obj/effect/turf_decal/stripes/closeup{
	dir = 1
	},
/obj/effect/decal/cleanable/dirt,
/obj/machinery/door/poddoor{
	id = "cargoload";
	name = "supply Dock Loading Door"
	},
/turf/open/floor/plating,
/area/shuttle/supply)
"t" = (
/obj/effect/turf_decal/stripes/line{
	dir = 8
	},
/obj/effect/decal/cleanable/dirt,
/obj/machinery/light{
	dir = 8
	},
/turf/open/floor/iron/smooth_edge{
	dir = 4
	},
/area/shuttle/supply)
"u" = (
/obj/effect/turf_decal/stripes/line{
	dir = 10
	},
/turf/open/floor/iron/smooth,
/area/shuttle/supply)
"v" = (
/obj/effect/turf_decal/bot,
/turf/open/floor/iron/smooth_large,
/area/shuttle/supply)
"w" = (
/obj/effect/turf_decal/stripes/line{
	dir = 4
	},
/obj/effect/decal/cleanable/dirt,
/obj/machinery/light{
	dir = 4
	},
/turf/open/floor/iron/smooth_edge{
	dir = 8
	},
/area/shuttle/supply)
"x" = (
/obj/effect/turf_decal/stripes/line,
/turf/open/floor/iron/smooth_edge{
	dir = 1
	},
/area/shuttle/supply)
"y" = (
/obj/effect/turf_decal/stripes/line,
/obj/effect/decal/cleanable/dirt,
/turf/open/floor/iron/smooth_edge{
	dir = 1
	},
/area/shuttle/supply)
"z" = (
/obj/structure/shuttle/engine/heater,
/obj/structure/window/reinforced{
	dir = 1
	},
/turf/open/floor/plating/airless,
/area/shuttle/supply)
"A" = (
/obj/effect/turf_decal/stripes/line{
	dir = 6
	},
/obj/effect/decal/cleanable/dirt,
/turf/open/floor/iron/smooth,
/area/shuttle/supply)
"B" = (
/turf/template_noop,
/area/template_noop)
"C" = (
/obj/structure/shuttle/engine/propulsion/burst/left,
/obj/effect/turf_decal/stripes/line,
/turf/open/floor/plating/airless,
/area/shuttle/supply)
"D" = (
/turf/open/space/basic,
/area/shuttle/supply)
"E" = (
/obj/effect/turf_decal/bot,
/obj/effect/decal/cleanable/oil,
/turf/open/floor/iron/smooth_large,
/area/shuttle/supply)
"L" = (
/obj/machinery/power/shieldwallgen/atmos/strong/roundstart{
	dir = 1;
	id = 1
	},
/obj/effect/turf_decal/stripes/closeup{
	dir = 1
	},
/obj/effect/decal/cleanable/dirt,
/obj/machinery/button/door{
	id = "cargoload";
	name = "Loading Doors";
	pixel_x = 8;
	pixel_y = -24
	},
/obj/effect/turf_decal/caution/stand_clear{
	dir = 4
	},
/obj/machinery/door/poddoor{
	id = "cargoload";
	name = "supply Dock Loading Door"
	},
/turf/open/floor/plating,
/area/shuttle/supply)
"R" = (
/obj/effect/turf_decal/bot,
/obj/effect/decal/cleanable/dirt,
/obj/effect/turf_decal/loading_area{
	dir = 8
	},
/turf/open/floor/iron/smooth_large,
/area/shuttle/supply)
"W" = (
/obj/effect/turf_decal/stripes/line{
	dir = 4
	},
/obj/effect/decal/cleanable/dirt,
/obj/machinery/conveyor{
	id = "cargoload";
	dir = 8
	},
/turf/open/floor/iron/smooth_edge{
	dir = 8
	},
/area/shuttle/supply)

(1,1,1) = {"
a
a
a
a
n
a
a
a
a
a
a
B
"}
(2,1,1) = {"
a
b
d
g
o
o
g
o
t
u
z
C
"}
(3,1,1) = {"
a
c
v
v
v
h
v
v
v
y
z
C
"}
(4,1,1) = {"
a
e
v
i
h
v
v
h
v
x
a
D
"}
(5,1,1) = {"
a
e
h
R
h
h
h
E
h
y
z
C
"}
(6,1,1) = {"
a
f
j
W
q
q
m
q
w
A
z
C
"}
(7,1,1) = {"
a
a
a
l
p
k
r
L
a
a
a
B
"}
