//MAP CONVERTED BY dmm2tgm.py THIS HEADER COMMENT PREVENTS RECONVERSION, DO NOT REMOVE
"a" = (
/obj/structure/fans/tiny,
/obj/docking_port/mobile/supply{
	dwidth = 3;
	height = 7;
	port_direction = 8;
	preferred_direction = 8;
	set_dir_on_move = 8;
	width = 5
	},
/obj/structure/shuttle/engine/propulsion{
	dir = 4
	},
/turf/open/floor/iron/textured,
/area/shuttle/supply)
"c" = (
/obj/effect/decal/cleanable/dirt/dust,
/obj/effect/decal/cleanable/dirt,
/obj/machinery/status_display/supply{
	pixel_y = -31
	},
/obj/machinery/light,
/obj/effect/turf_decal/stripes/line,
/turf/open/floor/iron/textured,
/area/shuttle/supply)
"d" = (
/obj/effect/turf_decal/stripes/line{
	dir = 6
	},
/obj/effect/decal/cleanable/dirt,
/turf/open/floor/iron/textured,
/area/shuttle/supply)
"f" = (
/obj/effect/decal/cleanable/dirt/dust,
/obj/effect/turf_decal/bot,
/obj/machinery/door/airlock/shuttle/glass{
	autoclose = 0.1;
	id_tag = "CargoAirlocks"
	},
/turf/open/floor/iron/textured,
/area/shuttle/supply)
"g" = (
/obj/effect/decal/cleanable/dirt,
/obj/effect/turf_decal/stripes/line{
	dir = 1
	},
/turf/open/floor/iron/textured,
/area/shuttle/supply)
"m" = (
/obj/effect/decal/cleanable/dirt/dust,
/turf/closed/wall/mineral/titanium/nodiagonal,
/area/shuttle/supply)
"n" = (
/turf/closed/wall/mineral/plastitanium,
/area/shuttle/supply)
"o" = (
/turf/closed/wall/mineral/titanium/nodiagonal,
/area/shuttle/supply)
"q" = (
/obj/effect/decal/cleanable/dirt/dust,
/obj/effect/turf_decal/stripes/line{
	dir = 10
	},
/turf/open/floor/iron/textured,
/area/shuttle/supply)
"t" = (
/obj/effect/decal/cleanable/dirt,
/obj/effect/decal/cleanable/dirt,
/obj/effect/turf_decal/stripes/line{
	dir = 1
	},
/obj/structure/shuttle/engine/heater{
	dir = 4
	},
/obj/effect/spawner/structure/window/shuttle,
/turf/open/floor/iron/textured,
/area/shuttle/supply)
"y" = (
/obj/effect/decal/cleanable/dirt,
/turf/open/floor/iron/textured,
/area/shuttle/supply)
"C" = (
/obj/structure/shuttle/engine/propulsion{
	dir = 4
	},
/turf/open/floor/plating/airless,
/area/shuttle/supply)
"D" = (
/obj/effect/decal/cleanable/dirt,
/obj/structure/shuttle/engine/heater{
	dir = 4
	},
/obj/effect/spawner/structure/window/shuttle,
/turf/open/floor/iron/textured,
/area/shuttle/supply)
"F" = (
/obj/effect/decal/cleanable/oil/streak,
/obj/effect/turf_decal/stripes/line{
	dir = 4
	},
/obj/effect/decal/cleanable/dirt,
/turf/open/floor/iron/textured,
/area/shuttle/supply)
"G" = (
/obj/effect/decal/cleanable/dirt/dust,
/obj/effect/turf_decal/stripes/line{
	dir = 1
	},
/turf/open/floor/iron/textured,
/area/shuttle/supply)
"H" = (
/obj/effect/decal/cleanable/dirt,
/obj/effect/turf_decal/stripes/line{
	dir = 8
	},
/turf/open/floor/iron/textured,
/area/shuttle/supply)
"I" = (
/obj/effect/decal/cleanable/dirt,
/obj/effect/turf_decal/stripes/line,
/turf/open/floor/iron/textured,
/area/shuttle/supply)
"K" = (
/obj/machinery/door/poddoor/shutters,
/turf/open/floor/iron/textured_half,
/area/shuttle/supply)
"R" = (
/obj/effect/decal/cleanable/dirt,
/obj/effect/turf_decal/stripes/line{
	dir = 5
	},
/turf/open/floor/iron/textured,
/area/shuttle/supply)
"T" = (
/obj/effect/decal/cleanable/dirt/dust,
/obj/structure/sign/warning/fire{
	pixel_x = 1;
	pixel_y = -33
	},
/obj/effect/turf_decal/stripes/line,
/obj/structure/shuttle/engine/heater{
	dir = 4
	},
/obj/effect/spawner/structure/window/shuttle,
/turf/open/floor/iron/textured,
/area/shuttle/supply)
"X" = (
/obj/effect/decal/cleanable/dirt/dust,
/turf/closed/wall/mineral/plastitanium,
/area/shuttle/supply)
"Y" = (
/obj/effect/decal/cleanable/dirt/dust,
/obj/effect/turf_decal/stripes/line{
	dir = 9
	},
/turf/open/floor/iron/textured,
/area/shuttle/supply)

(1,1,1) = {"
m
o
f
m
m
"}
(2,1,1) = {"
o
Y
H
q
m
"}
(3,1,1) = {"
K
g
y
I
m
"}
(4,1,1) = {"
K
G
y
c
m
"}
(5,1,1) = {"
K
R
F
d
o
"}
(6,1,1) = {"
o
t
D
T
o
"}
(7,1,1) = {"
n
C
a
C
X
"}
